Sansevieria
Ficus elastica
Monstera deliciosa
Epipremnum aureum
Spathiphyllum
Zamioculca zamiifolia
Dracaena marginata
Areca
Kentia
Maranta leuconeura
Calathea
Anthurium andraeanum
Aloe vera
Chlorophytum comosum
Dieffenbachia
Aglaonema
Peperomia
Cactus variados
Suculentas variadas
Philodendron scandens
Ficus benjamina
Guzmania
Vriesea
Begonia rex
Tradescantia zebrina
Hedera helix
Nephrolepis exaltata
Schefflera arboricola
Pilea peperomioides
Aspidistra elatior
Geranio
Petunia
Clavel
Impatiens
Hortensia
Azalea
Lavanda
Jazmín
Dalia
Gardenia
Margarita
Pensamiento
Verbena
Lantana
Rosa miniatura
Camelia
Fucsia
Hibiscus rosa-sinensis
Caléndula
Cyclamen
Romero
Tomillo
Albahaca
Menta
Laurel
Orégano
Salvia
Lavanda angustifolia
Aloe arborescens
Callistemon
Bougainvillea
Adelfa
Buganvilla
Jazmín polyanthum
Plumbago
Limonero
Naranjo
Olivo
Ficus carica
Hiedra (exterior)
Parra virgen
Cactus de jardín
Palmeras
Buxus sempervirens
Photinia
Pittosporum
Lavatera
Jasminum officinale
Cineraria
Clivia miniata
Musa
Caladium
Coleus
Alocasia
Croton
Crinum
Amaryllis
Heliconia
Ipomea
Oxalis triangularis
Senecio rowleyanus
Sedum morganianum
Kalanchoe
Tillandsia
Portulaca
Euryops
Nandina doméstica
Cactus de Navidad
Cinta variegada
Albahaca morada
Abedul – Betula pendula
Acebuche – Olea europaea (subsp. sylvestris)
Aceituna – Olea europaea
Acelga – Beta vulgaris (subsp. cicla)
Achicoria – Cichorium intybus
Acanto – Acanthus mollis
Aciano – Centaurea cyanus
Aguacate – Persea americana
Agave – Agave americana
Ajo – Allium sativum
Ajo cabaña – Allium cepa
Albahaca – Ocimum basilicum
Albaricoquero – Prunus armeniaca
Alcachofa – Cynara scolymus
Alcornoque – Quercus suber
Aldea (Peonia) – Paeonia mascula
Ajo silvestre – Allium ursinum
Ajenjo – Artemisia absinthium
Alfalfa – Medicago sativa
Algodón – Gossypium hirsutum
Aliso – Alnus glutinosa
Almez – Celtis australis
Almendro – Prunus dulcis
Almácigo – Acer monspessulanum (Almácigo)
Amaranto – Amaranthus caudatus
Azafrán – Crocus sativus
Azalea – Rhododendron simsii
Azucena – Lilium candidum
Bambú – Phyllostachys viridiglaucescens
Belladona – Atropa belladonna
Belén (Caléndula) – Calendula officinalis
Belén (Beleño) – Hyoscyamus niger
Boca de dragón – Antirrhinum majus
Boj – Buxus sempervirens
Borraja – Borago officinalis
Bugambilia – Bougainvillea glabra
Camelia – Camellia japonica
Campanilla – Hyacinthoides hispanica
Campanilla alpina – Soldanella alpina
Cardo borriquero – Eryngium maritimum
Cardo mariano – Silybum marianum
Cardo rabanero – Eryngium campestre
Cardo común – Dipsacus fullonum
Carlina – Carlina corymbosa
Carlán – Ferula communis (jargonella)
Carlopo – Acmella oleracea
Caña – Arundo donax
Cañaheja – Plantago coronopus
Calabacín – Cucurbita pepo
Calabaza – Cucurbita maxima
Calendula – Calendula officinalis
Campanilla – Lysimachia nummularia (Campanilla azul)
Campanita – Convolvulus arvensis
Cambronero – Lycium europaeum
Canónigos – Valerianella locusta
Cantueso – Lavandula stoechas
Cañaheja – Plantago coronopus
Caracolí – Buxus sempervirens
Cardenillo – Eryngium maritimum (sinónimo de cardo borriquero)
Cardencha – Euphorbia characias (coronilla de mar)
Cardo borriquero – Eryngium maritimum
Cardo rabanero – Eryngium campestre
Cardo comú – Dipsacus fullonum
Castilletes – Argemone mexicana (adormidera de prados)
Cañamo – Cannabis sativa
Cedro – Cedrus atlantica
Cedrón – Aloysia citrodora (Hierba Luisa)
Chumbera – Opuntia ficus-indica
Cilantro – Coriandrum sativum
Cinco hojas – Nepeta cataria (hierba del gato)
Clavel – Dianthus caryophyllus
Clavel de Venus – Ixia viridiflora (Nervia, Azucena de campo)
Clavelina – Silene colorata
Ciruela – Prunus domestica
Cisne (sauce) – Salix alba
Cital – Ricinus communis (Almiquí)
Citrón (limonero) – Citrus limon
Cistáceas (jardín) – numerosas especies (jaras)
Cofínia – Daphne gnidium (Tamarix, retama pelada)
Corimbo (Lavandula) – Lavandula latifolia
Coronilla de mar – Euphorbia characias
Correhuela – Calystegia sepium
Crotón – Codiaeum variegatum
Dalia – Dahlia pinnata
Dama de noche – Cestrum nocturnum
Drago – Dracaena draco
Durillo – Viburnum tinus
Eneldo – Anethum graveolens
Espárrago – Asparagus officinalis
Esparto – Stipa tenacissima
Espino albar – Crataegus monogyna
Espino cerval – Rhamnus lycioides
Espino negro – Rhamnus lycioides (sinónimo espino cerval)
Estragón – Artemisia dracunculus
Eucalipto – Eucalyptus globulus
Evonimo – Euonymus japonicus
Fresa – Fragaria × ananassa
Frambuesa – Rubus idaeus
Fresno – Fraxinus angustifolia
Fresno plateado – Fraxinus excelsior
Fresno falso – Ligustrum lucidum (mascarón)
Galán de noche – Cestrum nocturnum (Dama de noche)
Gazania – Gazania rigens
Geranio – Pelargonium × hortorum
Gerbera – Gerbera jamesonii
Girasol – Helianthus annuus
Granado – Punica granatum
Grama – diversas especies (pasto)
Hierba buena – Mentha spicata (sinónimo de hierbabuena)
Hierbaluisa – Aloysia citrodora (sinónimo Cedrón)
Hierbas luisa – Aloysia citrodora
Hierbabuena – Mentha spicata
Hiedra – Hedera helix
Higo chumbo – Opuntia ficus-indica (sinónimo Chumbera)
Higuerón – Ficus carica (higuera común)
Hinojo – Foeniculum vulgare
Hierbas varias – mayoría de aromáticas (tomillo, romero, orégano…)
Honesty (Flor de dinero) – Lunaria annua
Jacarandá – Jacaranda mimosifolia
Jara blanca – Cistus albidus
Jara pringosa – Cistus ladanifer
Jara real – Cistus monspeliensis
Jazmín – Jasminum officinale
Jara – término genérico para Cistus spp. (jaras)
Jara estepa – Cistus albidus (sinónimo Jara blanca)
Jaguarzo – Cistus clusii
Jarilla pringosa – Cistus ladanifer (sinónimo Jara pringosa)
Jara laurel – Cistus laurifolius
Lentisco – Pistacia lentiscus
Lechuga – Lactuca sativa
Lechuguilla – Yucca filamentosa (Agracejo, palo blanco)
Lila – Syringa vulgaris (lila común)
Lirio – Lilium candidum (azucena blanca)
Lobelia – Lobelia erinus
Loroco – Fernaldia pandurata (colate)
Madroño – Arbutus unedo
Manzanilla – Anthemis nobilis
Manzanilla agria – Tanacetum parthenium (Cola de caballo)
Mandarino – Citrus reticulata
Maíz – Zea mays
Malvavisco – Hibiscus syriacus (Rosa de Siria)
Malva – Malva sylvestris
Manzanilla – Matricaria recutita (Chamaemelum nobile)
Manzanilla silvestre – Tripleurospermum inodorum (engrasa)
Marihuana – Cannabis sativa
Marrubio – Marrubium vulgare
Martornell – Phillyrea angustifolia
Mastranto (Estramonio) – Datura stramonium (hierba del diablo)
Mayorana – Origanum majorana
Melisa – Melissa officinalis
Mirto – Myrtus communis
Morella – Morus alba (Morera)
Mostaza – Sinapis alba (o Brassica juncea)
Muérdago – Viscum album
Nandina – Nandina domestica (Nandina, a veces en jardines)
Nenúfar – Nymphaea alba (lirio de agua)
Nerolina – Nerium oleander (Adelfa)
Nogal – Juglans regia
Narciso (Aguileña) – Narcissus poeticus (narciso p\u00farpura)
Narciso trompeta – Narcissus tazetta
Nochebuena – Euphorbia pulcherrima
Nopal – Opuntia ficus-indica
Níspero – Eriobotrya japonica (Níspero del Japón)
Nogal – Juglans regia (Nogal común)
Orégano – Origanum vulgare
Ortiga – Urtica dioica
Ortiga blanca – Parietaria officinalis
Ortiguilla – Calystegia sepium (Correhuela)
Orquídea abeja – Ophrys apifera
Otoño – nombre local de Equisetum telmateia (cola de caballo)
Palmito – Chamaerops humilis
Palmera datilera – Phoenix dactylifera (Palmera de dátil)
Palmera canaria – Phoenix canariensis
Palmito – Chamaerops humilis (Palmito, pequeña palmera)
Palma – término genérico (diversas especies de palma)
Papaya – Carica papaya
Pepino – Cucumis sativus
Pepinos marinos – Paracucumaria multispina (no vascular, ignorable)
Petunia – Petunia × hybrida
Pensamiento – Viola tricolor
Perenquén (Selaginella) – Selaginella denticulata (no vascular)
Peral – Pyrus communis
Perdermisa – Portulaca oleracea (verdolaga)
Perejil – Petroselinum crispum
Petirrojo – Leonurus cardiaca (cantueso primitivo, ajugar)
Pinos varios – Pinus spp. (e.g. pino piñonero P. pinea, pino carrasco P. halepensis, pino laricio P. nigra, etc.)
Plátano – Musa paradisiaca (banano)
Plumbago – Plumbago auriculata
Poa (Pasto) – Poa pratensis (Pasto común)
Poleo – Mentha pulegium
Poleos marinos – Plantago coronopus (sinónimo cañaheja)
Pomelo – Citrus × paradisi
Prímula – Primula vulgaris
Puerro – Allium porrum
Quercus (Robles) – diversos roble andaluces (encina Q. ilex, quejigo Q. faginea, alcornoque Q. suber, coscoja Q. coccifera, etc.)
Rabanillo – Eruca vesicaria (rúcula)
Rabano – Raphanus sativus
Raicilla – Scilla peruviana (azulillo)
Retama – Retama monosperma
Retama blanca – Retama sphaerocarpa (retama olorosa)
Retama del pinar – Genista scorpius
Retama olorosa – Retama sphaerocarpa
Rosa – Rosa spp. (rosal, incl. rosa canina silvestre)
Rosmarino – Salvia rosmarinus (Romero)
Rosella – Amaranthus cruentus (amaranto)
Rubus (zarzamoras) – Rubus spp. (zarzamora R. ulmifolius, frambuesa R. idaeus, etc.)
Ruibarbo – Rheum rhabarbarum
Ruta – Ruta graveolens (Ruda)
Salvia – Salvia officinalis (Salvia común)
Saúco – Sambucus nigra
Sedum – Sedum sediforme (Pinguicula de fieltro / Jara japonesa)
Secuoya – Sequoiadendron giganteum
Setaso – Setaria italica (mijo de botijo)
Sorgo – Sorghum bicolor
Tomatera – Solanum lycopersicum
Tomatillo – Physalis philadelphica
Tagarnina – Silybum marianum (cardo mariano)
Tagetes – Tagetes erecta (Clavelón)
Tamarindo – Tamarindus indica
Tamarisco – Tamarix gallica
Taro – Colocasia esculenta
Tilo – Tilia platyphyllos
Tomillo – Thymus vulgaris
Tomillo de roca – Thymus mastichina
Tulipán – Tulipa gesneriana
Ullastre (Olivo silvestre) – Olea europaea subsp. europaea (acebuche)
Uva – Vitis vinifera (vid)
Verbena – Verbena officinalis
Valeriana – Valeriana officinalis
Verbena – Aloysia citrodora (Cedrón, María Luisa)
Viola – Viola odorata
Vincapervinca – Vinca minor
Vitex – Vitex agnus-castus (sauzgatillo)
Yucca – Yucca filamentosa
Zanahoria – Daucus carota
Zarzamora – Rubus ulmifolius (mora)
Zumaque – Rhus coriaria